############
#P       O #
#       ####
#          #
#######    #
#    ##    #
#    ##    #
#          #
#   O   XX #
#       #  #
############
